Phyllis	Young
Wanda	Perry
Andrea	Gonzalez
Annie	Perez
Kelly	White
David	Simmons
Brenda	Wood
Chris	Long
Shirley	Cox
Sarah	Butler
Ernest	Williams
Robert	Patterson
Samuel	James
Walter	Murphy
Nancy	Davis
Henry	Nelson
Kimberly	Washington
Cheryl	Collins
Johnny	Wilson
Joyce	Rivera
Jerry	Moore
Mildred	Russell
John	Flores
Marilyn	Lewis
Adam	Martinez
Janet	Morgan
Bobby	Adams
Lillian	King
Clarence	Brown
Peter	Hernandez
Kathy	Morris
Bonnie	Martin
Richard	Coleman
Michelle	Hughes
Tammy	Edwards
James	Smith
Denise	Diaz
Paula	Lee
Bruce	Rogers
Steven	Howard
Rachel	Baker
Teresa	Lopez
Amanda	Kelly
Jeremy	Torres
Roy	Bell
Helen	Peterson
Norma	Brooks
Martin	Wright
Thomas	Alexander
Tina	Turner
Donald	Powell
Barbara	Taylor
Jonathan	Cooper
Aaron	Robinson
Janice	Ward
Dennis	Harris
Joan	Scott
Sandra	Hill
Steve	Roberts
Albert	Bailey
Jacqueline	Thomas
Timothy	Bennett
Eugene	Watson
Craig	Parker
Cynthia	Anderson
Nicole	Mitchell
Roger	Jenkins
Diana	Garcia
Katherine	Ross
Ann	Sanders
Virginia	Phillips
Russell	Clark
William	Henderson
Mary	Carter
Brandon	Cook
Kevin	Rodriguez
Judith	Johnson
Dorothy	Allen
Marie	Campbell
Jane	Ramirez
Jason	Hall
Raymond	Richardson
Ryan	Jones
Irene	Barnes
Deborah	Gray
Andrew	Griffin
Sara	Gonzales
Jack	Evans
Willie	Price
Eric	Thompson
Ashley	Stewart
Jeffrey	Miller
Joshua	Jackson
Earl	Reed
Rose	Walker
Lawrence	Green
Anthony	Bryant
Patrick	Sanchez
Harold	Foster
Justin
